BBBBBBBBBB
G000G0000Y
G0G0G0RRRY
G0G000000Y
G0RRRR000Y
G0000Y0B0Y
GB000Y000Y
G00Y0RR0RY
G00Y00000Y
RRRRRRRRRR
